{
  "あ": 0,
  "い": 1,
  "う": 2,
  "え": 3,
  "お": 4,
  "か": 5,
  "き": 6,
  "く": 7,
  "け": 8,
  "こ": 9,
  "さ": 10,
  "し": 11,
  "す": 12,
  "せ": 13,
  "そ": 14,
  "た": 15,
  "ち": 16,
  "つ": 17,
  "て": 18,
  "と": 19,
  "な": 20,
  "に": 21,
  "ぬ": 22,
  "ね": 23,
  "の": 24,
  "は": 25,
  "ひ": 26,
  "ふ": 27,
  "へ": 28,
  "ほ": 29,
  "ま": 30,
  "み": 31,
  "む": 32,
  "め": 33,
  "も": 34,
  "や": 35,
  "ゆ": 36,
  "よ": 37,
  "ら": 38,
  "り": 39,
  "る": 40,
  "れ": 41,
  "ろ": 42,
  "わ": 43,
  "を": 44,
  "ん": 45,
  "ア": 46,
  "イ": 47,
  "ウ": 48,
  "エ": 49,
  "オ": 50,
  "カ": 51,
  "キ": 52,
  "ク": 53,
  "ケ": 54,
  "コ": 55,
  "サ": 56,
  "シ": 57,
  "ス": 58,
  "セ": 59,
  "ソ": 60,
  "タ": 61,
  "チ": 62,
  "ツ": 63,
  "テ": 64,
  "ト": 65,
  "ナ": 66,
  "ニ": 67,
  "ヌ": 68,
  "ネ": 69,
  "ノ": 70,
  "ハ": 71,
  "ヒ": 72,
  "フ": 73,
  "ヘ": 74,
  "ホ": 75,
  "マ": 76,
  "ミ": 77,
  "ム": 78,
  "メ": 79,
  "モ": 80,
  "ヤ": 81,
  "ユ": 82,
  "ヨ": 83,
  "ラ": 84,
  "リ": 85,
  "ル": 86,
  "レ": 87,
  "ロ": 88,
  "ワ": 89,
  "ヲ": 90,
  "ン": 91
}